9 12

############
#...#.#...##
#.###.#.#..#
#.#.#.#.##.#
#.#.#...##.#
#...#.#..#.#
#.#...#.##.#
0.#.###..#.e
############