12 12

############
##.....#...#
#..#.#.#.#.#
#.##.#.#.#.#
#..#.#.#.#.#
##.#.#0#.#.#
##.#.###.#.#
#..#...#.#.#
#.##.#...#.#
#..#.#####.#
##.#.....#e#
############