12 15

###############
#.........#...#
#.#.###.#.#.#.#
#.#.#.#.#.#.#.#
#.#.#.#.#.#.#.#
#.###.#.#...#.#
#.#.#.#.##.##.#
#.#.#.###.###.#
#.#.#..#.....0#
#.#,##.########
#............e#
###############