9 9

#########
0.#.#...#
#.#...#.#
#.#.###.#
#.#..#..#
#.##.#.##
#....#.##
#.####..e
#########