15 15

###############
#...##.#.#...##
#.#..#...#.#..#
#.#.#..#.#.#.##
#.#..#.#.#.#..#
#.#.#..#.#.##.#
#.#...##...#..#
#..#########0##
##.....#...#.##
##.###...###.##
##.#.###...####
##.#.##.##....#
####.....####.#
##.e.#.#......#
###############