6 9

#########
0.#...#.#
#.#.#.#.#
#.#.#...#
#...###.e
#########